La pastora - Coro Della Sat
La mia bela la mi aspeta - Coro Della Sat
Ta-pum! - Coro Della Sat
Stille Nacht - Austria Canto Natalizio - Coro Della Sat
Adeste Fideles - Coro Del Monte Cauriol
La Bela Giardiniera - Coro A.N.A. Di Milano
In cil e je une stele - Coro Della Sat
Era sera - Coro Della Sat
Interior Crocodile Alligator - Chip Tha Ripper
Como Llora - Juanfran
Ridere - Pinguini Tattici Nucleari
Toy Boy - Colapesce
MAKUMBA - Noemi
Dov'è - Le Vibrazioni
Andromeda (feat. Madame) - RMX - Elodie
Calma - Gaia
Supercalifragili (feat. Annalisa & Luca Di Stefano) - J-AX
In questa città - Max Pezzali
Ringo Starr - Pinguini Tattici Nucleari
Algoritmo (feat. Shaggy) (with Don Joe) - Willie Peyote
Andromeda (feat. Madame) - RMX - Elodie
Rose viola - Ghemon
La guerra di Piero - Fabrizio De André
Fotografia (feat. Francesca Michielin & Fabri Fibra) - Carl Brave
Crudelia De Mon - Stefano Bollani
Li'l Jack Horny - Extreme
La hit dell'estate - Shade
This Too Shall Pass - 8D Relaxium
Wellerman - Sea Shanty - Nathan Evans
Jerusalema (feat. Nomcebo Zikode) - Edit - Master KG
Daft Punk Medley - UN Ensamble
Chandelier - Kina Grannis
Can’t Help Falling in Love - Kina Grannis
Sayonara - Madh
Fight da faida - Original Version - Frankie hi-nrg mc
L'ANGELO CADUTO - feat. Shari - Salmo
Another One Bites The Dust / Otro Muerde El Polvo - Illya Kuryaki & The Valderramas
What a Wonderful World - Stacey Kent
Jericho - Iniko
With Arms Wide Open - Live Acoustic - Creed
Summer Nights - Van Halen
Young Blood - The Naked And Famous
Esseri umani - Marco Mengoni
La storia infinita - Pinguini Tattici Nucleari
sweater weather - omgkirby
Welcome to My Life - Simple Plan
Gli Insetti Del Podere - Caparezza
Man In The Mirror - Noah Guthrie
Shape Of You - acoustic - Chlara
What Is Love - Us The Duo
Cool Kids/Riptide (Originally Performed by Echosmith and Vance Joy) - Less Is More
You're Welcome (From "Moana") - Club Unicorn
Drunken Sailor - MALINDA
Never Gonna Give You Up - Rick Astley
Power - Marcus Miller
Yattaman - La Mente di Tetsuya
Legalize The Premier - Caparezza
Wild World - Acoustic Version - Joanna Wang
sweater weather - slowed + reverb - omgkirby
Hello - Erato
The Nights - Avicii
Sweet Child O' Mine - Taken By Trees
Tipsy - Club Mix - J-Kwon
Rather Be - Jasmine Thompson
Glycerine (Acoustic) - Bush
Oltre l'orizzonte - Chiara Grispo
Borrow - Silence 4
You're Welcome - Jordan Fisher/Lin-Manuel Miranda Version - Jordan Fisher
Hallelujah (feat. Choir! Choir! Choir!) - Rufus Wainwright
SBAM! - Rub-a-Dub Version - Jovanotti
The Greatest - Peter Bence
Use Somebody - Acoustic Version - Isabella Celander
KINDNESS. (with Attila) - aurorawave
Sangue Impazzito - Timoria
Nightshift - Commodores
Heart of Gold (615 Sessions) - Leah Blevins
Mr Red White and Blue - Coffey Anderson
When the Night Comes - Joe Cocker
Sugar - Acoustic Version - Maverick
Quelli che benpensano (feat. Riccardo Sinigallia) - Frankie hi-nrg mc
Ogni mio passo - Angela Finocchiaro
Girls Just Wanna Have Fun - Acoustic - The Mayries
From Here to Eternity - 2015 Remaster - Iron Maiden
Play That Funky Music - Wild Cherry
I Remember You - Skid Row
Impossible - I Am King
Cin Cin - Alfa
This Is Me - Keala Settle
Someone Like You - Nicholas McDonald
Hallelujah - Jeff Buckley
RISE & SHINE. (with Layton Meacham) - aurorawave
Risin' High - Def Core Grand Mix/Video Cut - H-Blockx
Cold as Ice - Blacklite District
Thunderstruck - AC/DC
Scene Three: II. Fatal Tragedy - Dream Theater
La vacinada - Checco Zalone
Time After Time - Iron & Wine
How Far I'll Go (feat. Rachel Potter) - VoicePlay
Ain't No Love In Oklahoma (From Twisters: The Album) - Luke Combs
malibu - sangiovanni
Dancing In The Dark - From The "Home" Soundtrack - Rihanna
CAN'T STOP THE FEELING! - Film Version - Justin Timberlake
Figli delle stelle [stilo croma latina] - Karaoke version - Italian Hitmakers
Master of Yachts - "The Professor" Nick Harrison
Chi Se Ne Frega Della Musica - Caparezza
Oltre l'orizzonte - Reprise - Chiara Grispo
Every Breath You Take (feat. Liza Anne) - Aaron Krause
No More Tears - Ozzy Osbourne
Don't Stop Believin' - Dan Lucas
MANCARSI - Coma_Cose
Pompeii - Ark Rhodes
Impossible - James Arthur
7 vizi Capitale - Piotta
Marble Machine - Wintergatan
